
NO ./sprites/NORD.xpm 



SO ./sprites/SUD.xpm


WE ./sprites/OUEST.xpm




EA ./sprites/EST.xpm

F      125,36,55
C      025,36,205












                 11111111
                 1N0000111
                 111111  1
                 111111111
1
1
1  
1
1
1
1
1
