
NO ./sprites/north_texture.xpm

SO ./sprites/south_texture.xpm


WE ./sprites/west_texture.xpm




EA ./sprites/east_texture.xpm

F      125,36,55
C      025,36,255


111111111111111111111111111111
111111111000000000000000011111
100000000000000000111000100001
110000100000000000000000001111
100001111111000000000000111111
1111111000000000W0000000000001
111100000000001100000000000011
110000000000000000000000000001
110000000000000000000000000001
110000000000000000000000000001
110000000000000000000000000001
110000000000000100000000000001
110000000000000000000000000001
110000000000000000000000000001
110000000000000000000000000001
110000000000011110000000000011
100000000000111000000000000011
110000000000111000000000001111
110000000001111000000000000111
111111111111111111111111111111111




          r




