
NO ./sprites/NORD.xpm

SO ./sprites/SUD.xpm


WE ./sprites/OUEST.xpm




EA ./sprites/EST.xpm

F      125,36,55
C      025,36,255












 1111111111111111111111111
1W000000001100000000000011111111111111111111111111
10110000000000000000001110000000000001
10010000000000000000000011111111111111111111111111
1111111110110000011100001111111111111111111111111111
10000000001100000100000000000000000000000000110011111111111
111100111111110111000000100011111111111111111111111111
1111001100000000000001100000001010010001
110000001101010111000000000011111111111111111111111111
100000000000000000000000010001
10000000000000000001010000001111111111111111111111111
1000000000110000010000000000000000000000000011001
100000000011000001000000000000000000000000001100111
100000000011000001000000000000000000000000001100001
100000000011000001000000000000000000000000000000001
10000000001100000100000000000000000000000000110011
110000011101010111110111100111111111111111111111111111
11110111 1110101 101111010001
11111111 1111111 111111111111



   





