
NO ./sprites/north_texture.xpm

SO ./sprites/south_texture.xpm


WE ./sprites/west_texture.xpm




EA ./sprites/east_texture.xpm


111111111111111111111111111111111
100000000000000000000000000000001
100000000000000000000000000000001
100000000000000000000000000000001
100000000000000000000000000000001
100000000000000000000000000000001
100000000000000000000000000000001
100000000000000000000000000000001
111111111111111111111111111111111





          




